00000001111100000000000000
00000022222222222001000000
00000000111000000000000000
00000000111111000000000000
00011111111000001000000000
00000000000000000000000000
00000000000000000000000000
00000000111111111100000000
00000000000000000000000000
00002000000000000000000000
00002000000000000000000000
00002000000000000000000000
00002000000000000000000000
00000000000000000000000000
00000000000000000000000000